a	a	conj
aa	aa	ign
abdominoplasty	abdominoplasty	subst:pltant:nom.acc:n
aby	aby	conj
ac	ac	ign
ach	ach	indecl
acz	acz	conj
aczkolwiek	aczkolwiek	conj
ad	ad	indecl
adad¿io	adad¿io	subst:sg:nom:n
adagio	adagio	subst:sg:nom:n
adieu	adieu	indecl
afro	afro	subst:sg:nom.gen.dat.acc.instr.loc.voc:n+subst:pl:nom.gen.dat.acc.instr.loc.voc:n
aha	aha	indecl
ahoj	ahoj	indecl
aju¶ci	aju¶ci	indecl
akropolis	akropolis	subst:sg:nom.gen.dat.acc.instr.loc.voc:n+subst:pl:nom.gen.dat.acc.instr.loc.voc:n
akurat	akurat	indecl
albedo	albedo	subst:sg:nom.acc.voc:n
albo	albo	conj
albowiem	albowiem	conj
albo¿	albo¿	indecl
ale	ale	conj
ale¿	ale¿	conj
alias	alias	subst:sg:nom.acc:m3
alibi	alibi	subst:sg:nom.gen.dat.acc.instr.loc.voc:n+subst:pl:nom.gen.dat.acc.instr.loc.voc:n
ali¶ci	ali¶ci	conj
allegretto	allegretto	subst:sg:nom.acc:n
allegro	allegro	subst:sg:nom.acc:n
alleluja	alleluja	indecl
amen	amen	indecl
andante	andante	subst:sg:nom.acc:n
andantino	andantino	subst:sg:nom.acc:n
ang	ang	ign
angora	angora	subst:sg:nom:m
ani	ani	conj
ani¿eli	ani¿eli	conj
ano	ano	indecl
aport	aport	subst:sg:nom:m
arioso	arioso	subst:sg:nom.acc:n
as	as	ign
asb	asb	ign
atelier	atelier	subst:sg:nom.gen.dat.acc.instr.loc.voc:n+subst:pl:nom.gen.dat.acc.instr.loc.voc:n
atm	atm	ign
atu	atu	subst:sg:nom.gen.dat.acc.instr.loc.voc:n+subst:pl:nom.gen.dat.acc.instr.loc.voc:n
au	au	ign
audio	audio	subst:sg:nom.gen.dat.acc.instr.loc.voc:n+subst:pl:nom.gen.dat.acc.instr.loc.voc:n
autocasco	autocasco	subst:sg:nom.gen.dat.acc.instr.loc.voc:n+subst:pl:nom.gen.dat.acc.instr.loc.voc:n
avocado	avocado	subst:sg:nom.acc.voc:n
awokado	awokado	subst:sg:nom.acc.voc:n
azali¿	azali¿	indecl
a¿	a¿	conj
a¿eby	a¿eby	conj
ba	ba	indecl
bajdu¶	bajdu¶	subst:sg:nom:m1
bajeczniej	bajeczniej	adv
bakier	bakier	adv
band¿o	band¿o	subst:sg:nom.gen.dat.acc.instr.loc.voc:n+subst:pl:nom.gen.dat.acc.instr.loc.voc:n
banjo	banjo	subst:sg:nom.gen.dat.acc.instr.loc.voc:n+subst:pl:nom.gen.dat.acc.instr.loc.voc:n
bardziej	bardziej	adv
bardzo	bardzo	adv
basta	basta	indecl
bd	bd	ign
bdb	bdb	ign
be	be	indecl
beaujolais	beaujolais	subst:sg:nom.gen.dat.acc.instr.loc.voc:n+subst:pl:nom.gen.dat.acc.instr.loc.voc:n
beta	beta	subst:sg:nom:f
bez	bez	prep:gen
bezcen	bezcen	adv
beze	beze	prep:gen
bezinteresowniej	bezinteresowniej	adv
bezkarniej	bezkarniej	adv
be¿	be¿	subst:sg:nom:m
bhp	bhp	ign
bielsko	bielsko	subst:sg:nom:n
biennale	biennale	subst:sg:nom.gen.dat.acc.instr.loc.voc:n+subst:pl:nom.gen.dat.acc.instr.loc.voc:n
bikini	bikini	subst:sg:nom.gen.dat.acc.instr.loc.voc:n+subst:pl:nom.gen.dat.acc.instr.loc.voc:n
bis	bis	subst:sg:nom:m
blanco	blanco	adv
bli¿ej	bli¿ej	adv
bln	bln	ign
blp	blp	ign
bm	bm	ign
bmw	bmw	ign
bo	bo	conj
boa	boa	subst:sg:nom.gen.dat.acc.instr.loc.voc:n+subst:pl:nom.gen.dat.acc.instr.loc.voc:n
bobo	bobo	subst:sg:nom.gen.dat.acc.instr.loc.voc:n+subst:pl:nom.gen.dat.acc.instr.loc.voc:n
bodaj¿e	bodaj¿e	indecl
bom	bom	subst:sg:nom:m
bordo	bordo	adv
bossa	bossa	indecl
bowiem	bowiem	conj
boæ	boæ	indecl
bpstwo	bpstwo	ign
brandy	brandy	subst:sg:nom.gen.dat.acc.instr.loc.voc:n+subst:pl:nom.gen.dat.acc.instr.loc.voc:n
brutto	brutto	subst:sg:nom.acc:n
bryk	bryk	subst:sg:nom:m
brzdêk	brzdêk	subst:sg:nom:m
buch	buch	indecl
buffo	buffo	subst:sg:nom.gen.dat.acc.instr.loc.voc:n+subst:pl:nom.gen.dat.acc.instr.loc.voc:n
bum	bum	indecl
by	by	conj
byle	byle	conj
bynajmniej	bynajmniej	conj
byæ	byæ	verb:inf:imperf
b±d¼	byæ	verb:impt:sg:sec:imperf
b±d¼	b±d¼	conj
b³p	b³p	ign
b³êdniej	b³êdniej	adv
bêc	bêc	indecl
bêdzie	byæ	verb:fin:sg:ter:imperf
bêdziecie	byæ	verb:fin:pl:sec:imperf
bêdziemy	byæ	verb:fin:pl:pri:imperf
bêdziesz	byæ	verb:fin:sg:sec:imperf
bêd±	byæ	verb:fin:pl:ter:imperf
bêdê	byæ	verb:fin:sg:pri:imperf
ca	ca	ign
cacy	cacy	adv
cal	cal	qub
camerlengo	camerlengo	subst:indecl:n
camerlingo	camerlingo	subst:indecl:n
canoe	canoe	subst:sg:nom.gen.dat.acc.instr.loc.voc:n+subst:pl:nom.gen.dat.acc.instr.loc.voc:n
cap	cap	subst:sg:nom:m
cargo	cargo	subst:sg:nom.gen.dat.acc.instr.loc.voc:n+subst:pl:nom.gen.dat.acc.instr.loc.voc:n
carmen	carmen	subst:sg:nom:m
carte	carte	subst:sg:nom.gen.dat.acc.instr.loc.voc:n+subst:pl:nom.gen.dat.acc.instr.loc.voc:n
cd	cd	qub
ce	ce	ign
cg	cg	ign
cha	cha	indecl
chan	chan	subst:sg:nom:m
chaps	chaps	indecl
chem	chem	ign
che³pliwiej	che³pliwiej	adv
chianti	chianti	subst:sg:nom.gen.dat.acc.instr.loc.voc:n+subst:pl:nom.gen.dat.acc.instr.loc.voc:n
chlast	chlast	indecl
chlust	chlust	subst:sg:nom:m
chocia¿	chocia¿	conj
chor	chor	ign
choæ	choæ	conj
choæby	choæby	conj
chyba	chyba	indecl
chy³kiem	chy³kiem	adv
ci	ci	qub
ciao	ciao	indecl
cichaczem	cichaczem	adv
cichcem	cichcem	adv
cichu	cichu	qub
ciemnoblond	ciemnoblond	adv
cieplej	cieplej	adv
circa	circa	indecl
cis	cis	subst:sg:nom:m
cisza	cisza	subst:sg:nom:f
ciszej	ciszej	adv
city	city	subst:sg:nom.gen.dat.acc.instr.loc.voc:n+subst:pl:nom.gen.dat.acc.instr.loc.voc:n
ciurkiem	ciurkiem	adv
ciut	ciut	adv
ciêgiem	ciêgiem	adv
ck	ck	ign
ckm	ckm	ign
cl	cl	qub
clg	clg	ign
clostridium	clostridium	subst:sg:nom.acc:n
clou	clou	subst:sg:nom.gen.dat.acc.instr.loc.voc:n+subst:pl:nom.gen.dat.acc.instr.loc.voc:n
cm	cm	qub
cocktailparty	cocktailparty	subst:sg:nom.gen.dat.acc.instr.loc.voc:n+subst:pl:nom.gen.dat.acc.instr.loc.voc:n
collage	collage	subst:sg:nom.gen.dat.acc.instr.loc.voc:n+subst:pl:nom.gen.dat.acc.instr.loc.voc:n
college	college	subst:sg:nom.gen.dat.acc.instr.loc.voc:n+subst:pl:nom.gen.dat.acc.instr.loc.voc:n
colog	colog	ign
com	com	ign
combi	combi	subst:sg:nom.gen.dat.acc.instr.loc.voc:n+subst:pl:nom.gen.dat.acc.instr.loc.voc:n
confetti	confetti	subst:sg:nom.gen.dat.acc.instr.loc.voc:n+subst:pl:nom.gen.dat.acc.instr.loc.voc:n
constans	constans	adv
contra	contra	subst:sg:nom:f
cop	cop	ign
coraz	coraz	indecl
cos	cos	ign
cosec	cosec	ign
cosh	cosh	ign
country	country	subst:sg:nom.gen.dat.acc.instr.loc.voc:n+subst:pl:nom.gen.dat.acc.instr.loc.voc:n
crescendo	crescendo	subst:sg:nom.acc:n
ctg	ctg	ign
curriculum	curriculum	subst:sg:nom.gen.dat.acc.instr.loc.voc:n
curry	curry	subst:sg:nom.gen.dat.acc.instr.loc.voc:n+subst:pl:nom.gen.dat.acc.instr.loc.voc:n
cyjankali	cyjankali	subst:sg:nom.gen.dat.acc.instr.loc.voc:n+subst:pl:nom.gen.dat.acc.instr.loc.voc:n
cyk	cyk	subst:sg:nom:m
czele	czele	qub
cze¶æ	cze¶æ	subst:sg:nom:f
czwórnasób	czwórnasób	adv
czy	czy	conj
czyli	czyli	conj
czyli¿	czyli¿	indecl
czy¿	czy¿	qub
czêstokroæ	czêstokroæ	adv
czê¶ciej	czê¶ciej	adv
dala	dala	adv
dalej	dalej	adv
dalej¿e	dalej¿e	indecl
dalibóg	dalibóg	indecl
dalipan	dalipan	indecl
dalm	dalm	ign
darmo	darmo	adv
dawien	dawien	adv
dawniej	dawniej	adv
db	db	ign
dcg	dcg	ign
dcl	dcl	qub
dcm	dcm	ign
dcn	dcn	ign
de	de	indecl
deka	deka	qub
dementi	dementi	subst:sg:nom.gen.dat.acc.instr.loc.voc:n+subst:pl:nom.gen.dat.acc.instr.loc.voc:n
dessous	dessous	subst:sg:nom.gen.dat.acc.instr.loc.voc:n+subst:pl:nom.gen.dat.acc.instr.loc.voc:n
desu	desu	subst:sg:nom.gen.dat.acc.instr.loc.voc:n+subst:pl:nom.gen.dat.acc.instr.loc.voc:n
dewanagari	dewanagari	adj:indecl
dg	dg	ign
dialektyczniej	dialektyczniej	adv
dingo	dingo	subst:sg:nom.gen.dat.acc.instr.loc.voc:m1+subst:pl:nom.gen.dat.acc.instr.loc.voc:m1
dis	dis	subst:sg:nom:m
disco	disco	subst:sg:nom.gen.dat.acc.instr.loc.voc:n+subst:pl:nom.gen.dat.acc.instr.loc.voc:n
dkg	dkg	ign
dkl	dkl	ign
dkm	dkm	ign
dl	dl	qub
dla	dla	prep:gen
dlaczego	dlaczego	indecl
dlaczego¿	dlaczego¿	indecl
dlaczegó¿	dlaczegó¿	indecl
dlatego	dlatego	conj
dlañ	dlañ	indecl
dm	dm	ign
do	do	prep:gen
dobranoc	dobranoc	indecl
dobroduszniej	dobroduszniej	adv
dobry	dobry	adj:sg:nom:m
docent	docent	subst:sg:nom:m
doko³a	doko³a	prep:gen
dok±d	dok±d	indecl
dok±dkolwiek	dok±dkolwiek	indecl
dok±d¶	dok±d¶	indecl
dolce	dolce	subst:sg:nom:n
donik±d	donik±d	indecl
dooko³a	dooko³a	prep:gen
dopiero	dopiero	adv
dopiero¿	dopiero¿	adv
dopok±d	dopok±d	indecl
doprawdy	doprawdy	adv
dopóki	dopóki	conj
dopóki¿	dopóki¿	conj
dopóty	dopóty	conj
dossier	dossier	subst:sg:nom.gen.dat.acc.instr.loc.voc:n+subst:pl:nom.gen.dat.acc.instr.loc.voc:n
dosyæ	dosyæ	adv
doszczêtniej	doszczêtniej	adv
dot	dot	ign
dotychczas	dotychczas	adv
dot±d	dot±d	indecl
dowolniej	dowolniej	adv
do¶æ	do¶æ	adv
doñ	doñ	indecl
dpi	dpi	ign
drzewiej	drzewiej	adv
ds	ds	ign
dst	dst	ign
dualis	dualis	subst:sg:nom.gen.dat.acc.instr.loc.voc:n+subst:pl:nom.gen.dat.acc.instr.loc.voc:n
dur	dur	subst:sg:nom:m
dwakroæ	dwakroæ	adv
dwt	dwt	ign
dwójnasób	dwójnasób	adv
dynamiczniej	dynamiczniej	adv
dypl	dypl	ign
dyplomatyczniej	dyplomatyczniej	adv
dyr	dyr	ign
dyrdum	dyrdum	subst:sg:nom.acc:n
dyw	dyw	ign
dzisiaj	dzisiaj	adv
dzi¶	dzi¶	adv		#dot±d!
dziêki	dziêki	prep:dat
dzyñ	dzyñ	indecl
d³u¿ej	d³u¿ej	adv
d¿udo	d¿udo	subst:sg:nom.acc.voc:n
ecu	ecu	subst:sg:nom.gen.dat.acc.instr.loc.voc:n+subst:pl:nom.gen.dat.acc.instr.loc.voc:n
ego	ego	subst:sg:nom.acc.voc:n
egoistyczniej	egoistyczniej	adv
egz	egz	ign
egzotyczniej	egzotyczniej	adv
ej	ej	indecl
ej¿e	ej¿e	indecl
ekg	ekg	ign
eks	eks	ign
ekspresywniej	ekspresywniej	adv
ekstra	ekstra	adv
em	em	ign
emploi	emploi	subst:sg:nom.gen.dat.acc.instr.loc.voc:n+subst:pl:nom.gen.dat.acc.instr.loc.voc:n
emu	emu	subst:sg:nom.gen.dat.acc.instr.loc.voc:n+subst:pl:nom.gen.dat.acc.instr.loc.voc:n
engagement	engagement	subst:sg:nom.gen.dat.acc.instr.loc.voc:n+subst:pl:nom.gen.dat.acc.instr.loc.voc:n
enigmatyczniej	enigmatyczniej	adv
er	er	ign
erl	erl	ign
es	es	subst:sg:nom.acc:m3
etc	etc	ign
etui	etui	subst:sg:nom.gen.dat.acc.instr.loc.voc:n+subst:pl:nom.gen.dat.acc.instr.loc.voc:n
etyczniej	etyczniej	adv
eureka	eureka	subst:sg:nom:f
ex	ex	indecl
explicite	explicite	adv
fair	fair	adv
faktotum	faktotum	subst:sg:nom.gen.dat.acc.instr.loc.voc:n
fali¶ciej	fali¶ciej	adv
fanatyczniej	fanatyczniej	adv
fa³	fa³	subst:sg:nom:m
fa³szywiej	fa³szywiej	adv
fe	fe	ign
fenomenalniej	fenomenalniej	adv
fermi	fermi	adj:sg:nom:m
ferro	ferro	adv
fest	fest	subst:sg:nom.acc:m3
fiat	fiat	subst:sg:nom:m
fiksum	fiksum	subst:sg:nom.gen.dat.acc.instr.loc.voc:n
fiku¶niej	fiku¶niej	adv
finezyjniej	finezyjniej	adv
fis	fis	subst:sg:nom.gen.dat.acc.instr.loc.voc:n+subst:pl:nom.gen.dat.acc.instr.loc.voc:n
fiut	fiut	subst:sg:nom:m
fizys	fizys	subst:sg:nom.gen.dat.acc.instr.loc.voc:n+subst:pl:nom.gen.dat.acc.instr.loc.voc:n
flamenco	flamenco	subst:sg:nom.gen.dat.acc.instr.loc.voc:n+subst:pl:nom.gen.dat.acc.instr.loc.voc:n
fm	fm	ign
foto	foto	indecl
foyer	foyer	subst:sg:nom.gen.dat.acc.instr.loc.voc:n+subst:pl:nom.gen.dat.acc.instr.loc.voc:n
fr	fr	ign
frajer	frajer	subst:sg:nom:m
franco	franco	adv
frutti	frutti	subst:sg:nom.gen.dat.acc.instr.loc.voc:n+subst:pl:nom.gen.dat.acc.instr.loc.voc:n
ft	ft	ign
fu	fu	indecl
fuj	fuj	indecl
ful	ful	subst:sg:nom:m
full	full	subst:sg:nom:m
furda	furda	indecl
gaga	gaga	subst:sg:nom:f
galant	galant	subst:sg:nom:m
gamma	gamma	subst:sg:nom:f
garden	garden	indecl
gdy	gdy	conj
gdyby¿	gdyby¿	conj
gdy¿	gdy¿	conj
gdzie	gdzie	indecl
gdziekolwiek	gdziekolwiek	indecl
gdzieniegdzie	gdzieniegdzie	indecl
gdzie¶	gdzie¶	indecl
gdzie¿	gdzie¿	indecl
git	git	subst:sg:nom:m
gnu	gnu	subst:sg:nom.gen.dat.acc.instr.loc.voc:n+subst:pl:nom.gen.dat.acc.instr.loc.voc:n
gore	gore	indecl
gr	gr	ign
graffiti	graffiti	subst:sg:nom.gen.dat.acc.instr.loc.voc:n+subst:pl:nom.gen.dat.acc.instr.loc.voc:n
grand	grand	subst:sg:nom:m
gratis	gratis	subst:sg:nom:m
gros	gros	subst:sg:nom:m
gul	gul	subst:sg:nom:m
guru	guru	subst:sg:nom:m1
gustowniej	gustowniej	adv
gwoli	gwoli	adj:sg:nom:m
gwoli	gwoli	qub
g³o¶niej	g³o¶niej	adv
g³êbiej	g³êbiej	adv
góra	góra	subst:sg:nom:f
ha	ha	indecl
hajda	hajda	subst:sg:nom:f
haj¿e	haj¿e	indecl
harakiri	harakiri	subst:sg:nom.gen.dat.acc.instr.loc.voc:n+subst:pl:nom.gen.dat.acc.instr.loc.voc:n
haram	haram	subst:sg:nom:m
harap	harap	subst:sg:nom:m
he	he	ign
hej	hej	indecl
hej¿e	hej¿e	indecl
hen	hen	indecl
het	het	indecl
hg	hg	ign
hindi	hindi	subst:sg:nom.gen.dat.acc.instr.loc.voc:n+subst:pl:nom.gen.dat.acc.instr.loc.voc:n
hindustani	hindustani	adj:indecl
hindustani	hindustani	adj:sg:nom:m
hl	hl	ign
hm	hm	indecl
ho	ho	indecl
hobby	hobby	subst:sg:nom.gen.dat.acc.instr.loc.voc:n+subst:pl:nom.gen.dat.acc.instr.loc.voc:n
hola	hola	indecl
holender	holender	subst:sg:nom:m
homo	homo	indecl
honoris	honoris	subst:sg:nom.gen.dat.acc.instr.loc.voc:n+subst:pl:nom.gen.dat.acc.instr.loc.voc:n
hop	hop	indecl
hopla	hopla	indecl
hopsasa	hopsasa	indecl
hosanna	hosanna	subst:sg:nom:f
hp	hp	ign
http	http	ign
huk	huk	subst:sg:nom:m
hura	hura	indecl
hurra	hurra	indecl
huzia	huzia	indecl
hyc	hyc	indecl
hê	hê	indecl
i	i	conj
ibidem	ibidem	indecl
igloo	igloo	subst:sg:nom.gen.dat.acc.instr.loc.voc:n+subst:pl:nom.gen.dat.acc.instr.loc.voc:n
ii	ii	qub
iii	iii	qub
ilekroæ	ilekroæ	adv
im	im	conj
implicite	implicite	adv
imprimatur	imprimatur	subst:sg:nom.gen.dat.acc.instr.loc.voc:n+subst:pl:nom.gen.dat.acc.instr.loc.voc:n
impromptu	impromptu	subst:sg:nom.gen.dat.acc.instr.loc.voc:n+subst:pl:nom.gen.dat.acc.instr.loc.voc:n
in	in	ign
inaczej	inaczej	adv
incognito	incognito	adv
indziej	indziej	adv
inf	inf	ign
ino	ino	indecl
instant	instant	adv
inte	inte	ign
interesowniej	interesowniej	adv
inv	inv	ign
ironiczniej	ironiczniej	adv
itd	itd	ign
itp	itp	ign
i¶cie	i¶cie	adv
i¿	i¿	conj
i¿by	i¿by	conj
ja	ja	ppron:nom.voc:sg
jak	jak	conj
jakkolwiek	jakkolwiek	conj
jako	jako	conj
jakoby	jakoby	conj
jako¶	jako¶	indecl
jako¿	jako¿	indecl
jak¿e	jak¿e	adv
jak¿e¿	jak¿e¿	indecl
jamboree	jamboree	subst:sg:nom.gen.dat.acc.instr.loc.voc:n+subst:pl:nom.gen.dat.acc.instr.loc.voc:n
jasnoblond	jasnoblond	adv
jazda	jazda	subst:sg:nom:f
ja¶nie	ja¶nie	adv
jednak	jednak	conj
jednak¿e	jednak¿e	conj
jednonó¿	jednonó¿	adv
jednor±cz	jednor±cz	adv
jeno	jeno	adv
jest	byæ	verb:fin:sg:ter:imperf
jestem	byæ	verb:fin:sg:pri:imperf
jeste¶	byæ	verb:fin:sg:sec:imperf
jeste¶cie	byæ	verb:fin:pl:sec:imperf
jeste¶my	byæ	verb:fin:pl:pri:imperf
jeszcze	jeszcze	indecl
je¶li	je¶li	conj
je¶liby	je¶liby	conj
je¿eli	je¿eli	conj
jinja	jinja	subst:sg:nom:f
joint	joint	subst:sg:nom:m
judo	judo	subst:sg:nom.acc.voc:n
jujitsu	jujitsu	subst:sg:nom.gen.dat.acc.instr.loc.voc:n+subst:pl:nom.gen.dat.acc.instr.loc.voc:n
jutro	jutro	subst:sg:nom.acc:n
ju¿	ju¿	indecl
ju¿ci	ju¿ci	indecl
ju¿em	ju¿em	indecl
ka	ka	ign
kakadu	kakadu	subst:sg:nom.gen.dat.acc.instr.loc.voc:n+subst:pl:nom.gen.dat.acc.instr.loc.voc:n
kamikadze	kamikadze	subst:sg:nom.gen.dat.acc.instr.loc.voc:m1+subst:pl:nom.gen.dat.acc.instr.loc.voc:m1
kamikaze	kamikaze	subst:sg:nom.gen.dat.acc.instr.loc.voc:m1+subst:pl:nom.gen.dat.acc.instr.loc.voc:m1
kan	kan	ign
kanada	kanada	subst:sg:nom:f
kanoe	kanoe	subst:sg:nom.gen.dat.acc.instr.loc.voc:n+subst:pl:nom.gen.dat.acc.instr.loc.voc:n
kaput	kaput	indecl
karate	karate	subst:sg:nom.gen.dat.acc.instr.loc.voc:n+subst:pl:nom.gen.dat.acc.instr.loc.voc:n
karibu	karibu	subst:sg:nom.gen.dat.acc.instr.loc.voc:n+subst:pl:nom.gen.dat.acc.instr.loc.voc:n
karo	karo	subst:sg:nom.acc:n
karygodniej	karygodniej	adv
kaszubsko	kaszubsko	adv
kata	kata	subst:sg:nom:f
kategoryczniej	kategoryczniej	adv
katharsis	katharsis	subst:sg:nom.gen.dat.acc.instr.loc.voc:n+subst:pl:nom.gen.dat.acc.instr.loc.voc:n
kb	kb	ign
kbar	kbar	ign
kbk	kbk	ign
kbks	kbks	ign
kc	kc	ign
kcal	kcal	ign
kdyn	kdyn	ign
kepi	kepi	subst:sg:nom.gen.dat.acc.instr.loc.voc:n+subst:pl:nom.gen.dat.acc.instr.loc.voc:n
kg	kg	ign
khaki	khaki	adj:sg:indecl:m
khaki	khaki	adj:sg:nom:m
kic	kic	subst:sg:nom:m
kiedykolwiek	kiedykolwiek	adv
kiedy¶	kiedy¶	indecl
kiedy¿	kiedy¿	conj
kilkakroæ	kilkakroæ	adv
kiwi	kiwi	subst:sg:nom.gen.dat.acc.instr.loc.voc:n+subst:pl:nom.gen.dat.acc.instr.loc.voc:n
kk	kk	ign
klitu¶	klitu¶	indecl
klops	klops	subst:sg:nom:m
km	km	ign
kmdr	kmdr	ign
kmdt	kmdt	ign
kombi	kombi	subst:sg:nom.gen.dat.acc.instr.loc.voc:n+subst:pl:nom.gen.dat.acc.instr.loc.voc:n
kompletniej	kompletniej	adv
konfetti	konfetti	subst:sg:nom.gen.dat.acc.instr.loc.voc:n+subst:pl:nom.gen.dat.acc.instr.loc.voc:n
kongo	kongo	subst:sg:nom:m
konklawe	konklawe	subst:sg:nom.gen.dat.acc.instr.loc.voc:n+subst:pl:nom.gen.dat.acc.instr.loc.voc:n
konsekwentniej	konsekwentniej	adv
kontra	kontra	prep:nom
kordialniej	kordialniej	adv
korrobori	korrobori	adj:indecl
korrobori	korrobori	adj:sg:nom:m
ko³o	ko³o	prep:gen
kp	kp	ign
kpr	kpr	ign
kra	kra	subst:sg:nom:f
krwawiej	krwawiej	adv
krzywiej	krzywiej	adv
krócej	krócej	adv
ksero	ksero	subst:sg:nom.acc.voc:n
którêdy	którêdy	indecl
którêdykolwiek	którêdykolwiek	adv
ku	ku	prep:dat
kukuryku	kukuryku	indecl
kum	kum	subst:sg:nom:m
kwa	kwa	ign
kwieci¶ciej	kwieci¶ciej	adv
kwita	kwita	subst:sg:nom:f
kysz	kysz	indecl
kêdy	kêdy	adv
kêdy¶	kêdy¶	indecl
la	la	indecl
lada	lada	subst:sg:nom:f
ladaco	ladaco	subst:sg:nom.gen.dat.acc.instr.loc.voc:m1+subst:pl:nom.gen.dat.acc.instr.loc.voc:m1
larghetto	larghetto	subst:sg:nom.acc:n
largo	largo	subst:sg:nom.acc:n
latina	latina	subst:sg:nom:f
lecz	lecz	conj
legato	legato	indecl
lelum	lelum	subst:sg:nom.gen.dat.acc.instr.loc.voc:n+subst:pl:nom.gen.dat.acc.instr.loc.voc:n
lepiej	lepiej	adv
li	li	indecl
lido	lido	subst:sg:nom.acc.voc:n
lila	lila	adv
lilaró¿	lilaró¿	adv
liryczniej	liryczniej	adv
lito¶ciwiej	lito¶ciwiej	adv
lobby	lobby	subst:sg:nom.gen.dat.acc.instr.loc.voc:n+subst:pl:nom.gen.dat.acc.instr.loc.voc:n
lobo	lobo	subst:sg:nom.gen.dat.acc.instr.loc.voc:n+subst:pl:nom.gen.dat.acc.instr.loc.voc:n
loco	loco	adv
loko	loko	indecl
lotto	lotto	subst:sg:nom.acc.voc:n
lu	lu	ign
lub	lub	conj
lubo	lubo	adv
luli	luli	indecl
lumbago	lumbago	subst:sg:nom.acc.voc:n
lx	lx	qub
l¿ej	l¿ej	adv
ma	mieæ	verb:fin:sg:ter:imperf
ma	mój	adj:sg:nom:f:pos
mach	mach	subst:sg:nom:m
machinalniej	machinalniej	adv
majestatyczniej	majestatyczniej	adv
makro	makro	subst:sg:nom.acc:n
maksi	maksi	subst:sg:nom.gen.dat.acc.instr.loc.voc:n+subst:pl:nom.gen.dat.acc.instr.loc.voc:n
maksimum	maksimum	subst:sg:nom.acc:n
mango	mango	subst:sg:nom:n
marengo	marengo	subst:sg:nom.acc:n
ma³o¿	ma³o¿	adv
maæ	maæ	subst:sg:nom:f
mbar	mbar	ign
mec	mec	ign
melancholijniej	melancholijniej	adv
melodyjniej	melodyjniej	adv
memento	memento	subst:sg:nom.acc.voc:n
menu	menu	subst:sg:nom.gen.dat.acc.instr.loc.voc:n+subst:pl:nom.gen.dat.acc.instr.loc.voc:n
merit	merit	subst:sg:nom:m
mg	mg	ign
mgli¶ciej	mgli¶ciej	adv
mgr	mgr	ign
mi	mi	qub
mianowicie	mianowicie	adv
milady	milady	subst:sg:nom.gen.dat.acc.instr.loc.voc:f+subst:pl:nom.gen.dat.acc.instr.loc.voc:f
millefiori	millefiori	adj:indecl
millefiori	millefiori	adj:sg:nom:m
mimo	mimo	prep:gen
mimochodem	mimochodem	adv
mini	mini	subst:sg:nom.gen.dat.acc.instr.loc.voc:n+subst:pl:nom.gen.dat.acc.instr.loc.voc:n
minor	minor	subst:sg:nom:m
miss	miss	subst:sg:nom.gen.dat.acc.instr.loc.voc:f+subst:pl:nom.gen.dat.acc.instr.loc.voc:f
miêdzy	miêdzy	prep:instr
mld	mld	ign
mln	mln	ign
moderato	moderato	subst:sg:nom.acc:n
modniej	modniej	adv
moll	moll	subst:sg:nom.gen.dat.acc.instr.loc.voc:n+subst:pl:nom.gen.dat.acc.instr.loc.voc:n
mono	mono	adv
monotonniej	monotonniej	adv
monumentalniej	monumentalniej	adv
mo¿na	mo¿na	pred
mo¿na¿	mo¿na¿	pred
mruczando	mruczando	subst:sg:nom:n
mrukliwiej	mrukliwiej	adv
multum	multum	subst:sg:nom.gen.dat.acc.instr.loc.voc:n
mylniej	mylniej	adv
m±drzej	m±drzej	adv
m³odu	m³odu	adv
m¶ciwiej	m¶ciwiej	adv
na	na	prep:loc
nad	nad	prep:instr
nadal	nadal	adv
nade	nade	prep:instr
nader	nader	adv
nadto	nadto	adv
najbajeczniej	najbajeczniej	adv
najbardziej	najbardziej	adv
najbli¿ej	najbli¿ej	adv
najb³êdniej	najb³êdniej	adv
najche³pliwiej	najche³pliwiej	adv
najchêtniej	najchêtniej	adv
najcieniej	najcieniej	adv
najciszej	najciszej	adv
najczerwieniej	najczerwieniej	adv
najczê¶ciej	najczê¶ciej	adv
najdalej	najdalej	adv
najdestruktywniej	najdestruktywniej	adv
najdobroduszniej	najdobroduszniej	adv
najdoszczêtniej	najdoszczêtniej	adv
najdowolniej	najdowolniej	adv
najdynamiczniej	najdynamiczniej	adv
najdyplomatyczniej	najdyplomatyczniej	adv
najdziecinniej	najdziecinniej	adv
najd³u¿ej	najd³u¿ej	adv
najegoistyczniej	najegoistyczniej	adv
najegzotyczniej	najegzotyczniej	adv
najetyczniej	najetyczniej	adv
najfa³szywiej	najfa³szywiej	adv
najfenomenalniej	najfenomenalniej	adv
najfiku¶niej	najfiku¶niej	adv
najfinezyjniej	najfinezyjniej	adv
najgorzej	najgorzej	adv
najgorêcej	najgorêcej	adv
najgustowniej	najgustowniej	adv
najhardziej	najhardziej	adv
najkrócej	najkrócej	adv
najkwieci¶ciej	najkwieci¶ciej	adv
najlepiej	najlepiej	adv
najliryczniej	najliryczniej	adv
najmelodyjniej	najmelodyjniej	adv
najmgli¶ciej	najmgli¶ciej	adv
najmniej	najmniej	adv
najmocniej	najmocniej	adv
najmonotonniej	najmonotonniej	adv
najmylniej	najmylniej	adv
najm¶ciwiej	najm¶ciwiej	adv
najobiektywniej	najobiektywniej	adv
najpazerniej	najpazerniej	adv
najpesymistyczniej	najpesymistyczniej	adv
najpierw	najpierw	indecl
najpochlebniej	najpochlebniej	adv
najpowierzchowniej	najpowierzchowniej	adv
najprawdopodobniej	najprawdopodobniej	adv
najprymitywniej	najprymitywniej	adv
najprzód	najprzód	adv
najprêdzej	najprêdzej	adv
najp³omienniej	najp³omienniej	adv
najp³ycej	najp³ycej	adv
najpó¼niej	najpó¼niej	adv
najsamotniej	najsamotniej	adv
najsko¶niej	najsko¶niej	adv
najsuszej	najsuszej	adv
najswoi¶ciej	najswoi¶ciej	adv
najszczegó³owiej	najszczegó³owiej	adv
najszybciej	najszybciej	adv
najtaniej	najtaniej	adv
najtêpiej	najtêpiej	adv
najuczeniej	najuczeniej	adv
najuni¿eniej	najuni¿eniej	adv
najupojniej	najupojniej	adv
najuszczypliwiej	najuszczypliwiej	adv
najwadliwiej	najwadliwiej	adv
najwcze¶niej	najwcze¶niej	adv
najwidoczniej	najwidoczniej	adv
najwiêcej	najwiêcej	adv
najwykrêtniej	najwykrêtniej	adv
najwyra¼niej	najwyra¼niej	adv
najwy¿ej	najwy¿ej	adv
najw¶cieklej	najw¶cieklej	adv
najwêziej	najwêziej	adv
najza¿arciej	najza¿arciej	adv
najzieleniej	najzieleniej	adv
najzupe³niej	najzupe³niej	adv
najz³oci¶ciej	najz³oci¶ciej	adv
naj³acniej	naj³acniej	adv
naj³apczywiej	naj³apczywiej	adv
naj³atwiej	naj³atwiej	adv
naj¶mielej	naj¶mielej	adv
naoko³o	naoko³o	prep:gen
naokó³	naokó³	prep:gen
naonczas	naonczas	adv
naprawdê	naprawdê	adv
naprzeciw	naprzeciw	prep:gen.dat
naprzeciwka	naprzeciwka	adv
naprzeciwko	naprzeciwko	prep:gen.dat
naprzód	naprzód	subst:sg:nom.acc:m3
naprêdce	naprêdce	adv
naraz	naraz	indecl
nareszcie	nareszcie	adv
natomiast	natomiast	conj
natychmiast	natychmiast	adv
nawet	nawet	indecl
nawzajem	nawzajem	adv
nazajutrz	nazajutrz	adv
nazbyt	nazbyt	adv
nañ	nañ	indecl
naówczas	naówczas	adv
netto	netto	subst:sg:nom.acc:n
ni	ni	conj
nie	nie	indecl
niebawem	niebawem	adv
niebieskolila	niebieskolila	adv
niech	niech	indecl
niechaj	niechaj	indecl
niechaj¿e	niechaj¿e	indecl
niechc±cy	niechc±cy	pact
niech¿e	niech¿e	indecl
nieco	nieco	adv
nieco¶	nieco¶	indecl
niegdy¶	niegdy¶	indecl
niemal	niemal	adv
niemal¿e	niemal¿e	adv
nienaruszenie	nienaruszenie	subst:sg:nom.acc:n
nieprawda	nieprawda	subst:sg:nom:f
nieprzymuszenie	nieprzymuszenie	subst:sg:nom.acc:n
nieskomplikowanie	nieskomplikowanie	subst:sg:nom.acc:n
nieskoñczenie	nieskoñczenie	adv
niespe³na	niespe³na	adv
niestety	niestety	adv
niezad³ugo	niezad³ugo	adv
niezas³u¿enie	niezas³u¿enie	adv
nigdy	nigdy	indecl
nigdzie	nigdzie	indecl
nijak	nijak	adv
nike	nike	subst:sg:nom.gen.dat.acc.instr.loc.voc:f+subst:pl:nom.gen.dat.acc.instr.loc.voc:f
nikogusieñko	nikogusieñko	adv
nikoguteñko	nikoguteñko	adv
nim	nim	conj
ni¼li	ni¼li	indecl
ni¿	ni¿	conj
ni¿ej	ni¿ej	adv
ni¿eli	ni¿eli	adv
no	no	indecl
nobliwiej	nobliwiej	adv
nomina	nomina	subst:sg:nom:f
notabene	notabene	adv
novum	novum	subst:sg:nom.gen.dat.acc.instr.loc.voc:n
np	np	ign
nr	nr	ign
nu¿e	nu¿e	indecl
o	o	prep:acc.loc
obel¿ywiej	obel¿ywiej	adv
obiektywniej	obiektywniej	adv
obok	obok	prep:gen
obsequium	obsequium	subst:sg:nom.acc:n
obunó¿	obunó¿	adv
obur±cz	obur±cz	adv
oby¿	oby¿	indecl
och	och	indecl
od	od	prep:gen
ode	ode	prep:gen
odeñ	odeñ	indecl
odk±d	odk±d	indecl
odno¶nie	odno¶nie	prep:gen
odt±d	odt±d	indecl
oho	oho	indecl
oj	oj	indecl
ojej	ojej	indecl
okapi	okapi	subst:sg:nom.gen.dat.acc.instr.loc.voc:n+subst:pl:nom.gen.dat.acc.instr.loc.voc:n
oko³o	oko³o	adv
okrakiem	okrakiem	adv
omnium	omnium	subst:sg:nom.acc:n
onegdaj	onegdaj	adv
ongi	ongi	indecl
ongi¶	ongi¶	indecl
opak	opak	indecl
opr	opr	ign
oprócz	oprócz	prep:gen
oraz	oraz	conj
ot	ot	indecl
otello	otello	subst:sg:nom:m
oto	oto	indecl
otó¿	otó¿	indecl
owak	owak	indecl
owszem	owszem	indecl
owêdy	owêdy	indecl
ozdobniej	ozdobniej	adv
pa	pa	ign
pac	pac	subst:sg:nom:m
panta	panta	subst:sg:nom:f
pardon	pardon	subst:sg:nom:m
parokroæ	parokroæ	adv
party	party	adj:sg:nom:m
pas	pas	subst:sg:nom:m
paternoster	paternoster	subst:sg:nom.gen.dat.acc.instr.loc.voc:n+subst:pl:nom.gen.dat.acc.instr.loc.voc:n
patria	patria	subst:sg:nom:f
patriotyczniej	patriotyczniej	adv
pazerniej	pazerniej	adv
pedantyczniej	pedantyczniej	adv
pendant	pendant	subst:sg:nom.gen.dat.acc.instr.loc.voc:m1+subst:pl:nom.gen.dat.acc.instr.loc.voc:m1
pepsi	pepsi	subst:sg:nom.gen.dat.acc.instr.loc.voc:n+subst:pl:nom.gen.dat.acc.instr.loc.voc:n
per	per	prep:nom
perli¶ciej	perli¶ciej	adv
pesymistyczniej	pesymistyczniej	adv
pianissimo	pianissimo	subst:sg:nom.acc.voc:n
piano	piano	subst:sg:nom.acc:n
pieczo³owiciej	pieczo³owiciej	adv
pierwej	pierwej	adv
pik	pik	subst:sg:nom:m
piure	piure	subst:sg:nom.gen.dat.acc.instr.loc.voc:n+subst:pl:nom.gen.dat.acc.instr.loc.voc:n
pkt	pkt	ign
placet	placet	subst:sg:nom.acc:m3
plask	plask	subst:sg:nom:m
plateau	plateau	subst:sg:nom.gen.dat.acc.instr.loc.voc:n+subst:pl:nom.gen.dat.acc.instr.loc.voc:n
plum	plum	indecl
plusk	plusk	subst:sg:nom:m
pm	pm	ign
po	po	prep:acc.loc
pochlebniej	pochlebniej	adv
pocieszniej	pocieszniej	adv
pod	pod	prep:gen.acc.instr
podczas	podczas	prep:gen
pode	pode	prep:gen.acc.instr
podeñ	podeñ	indecl
podle	podle	prep:gen
pod³ug	pod³ug	prep:gen
podówczas	podówczas	adv
pokrótce	pokrótce	adv
pok±d	pok±d	indecl
pok±d¿e	pok±d¿e	adv
pomaleñku	pomaleñku	adv
pomalutku	pomalutku	adv
pomimo	pomimo	prep:gen
pomiêdzy	pomiêdzy	prep:acc.instr
ponad	ponad	prep:acc.instr
ponadto	ponadto	adv
poniek±d	poniek±d	indecl
poniewa¿	poniewa¿	conj
poniewczasie	poniewczasie	adv
poni¿ej	poni¿ej	prep:gen
pono	pono	indecl
ponoæ	ponoæ	adv
pony	pony	subst:sg:nom.gen.dat.acc.instr.loc.voc:m1+subst:pl:nom.gen.dat.acc.instr.loc.voc:m1
pop	pop	subst:sg:nom:m
popod	popod	indecl
poprzek	poprzek	adv
poprzez	poprzez	prep:acc
porno	porno	subst:sg:nom:m
pospo³u	pospo³u	adv
poste	poste	subst:sg:nom.gen.dat.acc.instr.loc.voc:n+subst:pl:nom.gen.dat.acc.instr.loc.voc:n
posuwi¶ciej	posuwi¶ciej	adv
potpourri	potpourri	subst:sg:nom.gen.dat.acc.instr.loc.voc:n+subst:pl:nom.gen.dat.acc.instr.loc.voc:n
pot±d	pot±d	indecl
powoli	powoli	adv
powoluteñku	powoluteñku	adv
powolutku	powolutku	adv
powy¿ej	powy¿ej	prep:gen
poza	poza	prep:instr
pozawczoraj	pozawczoraj	adv
po¶rodku	po¶rodku	prep:gen
po¶ród	po¶ród	prep:gen
pp³k	pp³k	ign
prask	prask	indecl
prawo	prawo	subst:sg:nom.acc:n
precz	precz	indecl
prima	prima	indecl
pro	pro	adv
prof	prof	ign
prosperity	prosperity	subst:sg:nom:n
prostu	prostu	adv
pryma	pryma	subst:sg:nom:f
prymaprylis	prymaprylis	subst:sg:nom:m
przecie¿	przecie¿	indecl
przeciw	przeciw	prep:gen.dat
przeciwko	przeciwko	prep:gen.dat
przed	przed	prep:acc.instr
przede	przede	prep:acc.instr
przedeñ	przedeñ	indecl
przedtem	przedtem	indecl
przedwczoraj	przedwczoraj	adv
przenigdy	przenigdy	indecl
przeto	przeto	conj
przewa¿nie	przewa¿nie	adv
przez	przez	prep:acc
przeze	przeze	prep:acc
przezeñ	przezeñ	adv
przy	przy	prep:loc
przynajmniej	przynajmniej	adv
przyp	przyp	ign
prêdzej	prêdzej	adv
prócz	prócz	prep:gen
pró¿no	pró¿no	adv
psi	psi	adj:sg:nom:m
psiakostka	psiakostka	subst:sg:nom:f
psiako¶æ	psiako¶æ	indecl
psiakrew	psiakrew	indecl
psiamaæ	psiamaæ	indecl
psik	psik	indecl
psyche	psyche	subst:sg:nom.gen.dat.acc.instr.loc.voc:n+subst:pl:nom.gen.dat.acc.instr.loc.voc:n
psyk	psyk	subst:sg:nom:m
puf	puf	subst:sg:nom:m
puff	puff	subst:sg:nom:m
punkt	punkt	subst:sg:nom:m
pycha	pycha	subst:sg:nom:f
pyk	pyk	indecl
p³ask	p³ask	adv
p³k	p³k	ign
p³omienniej	p³omienniej	adv
p³ycej	p³ycej	adv
póki	póki	conj
póty	póty	conj
pó³darmo	pó³darmo	adv
pó³gêbkiem	pó³gêbkiem	adv
pó³nocno	pó³nocno	adv
pó³serio	pó³serio	adv
pó³uchem	pó³uchem	adv
pó¼niej	pó¼niej	adv
quasi	quasi	adv
quo	quo	indecl
raczej	raczej	adv
raniusieñko	raniusieñko	adv
raniuteñko	raniuteñko	adv
raniutko	raniutko	adv
rano	rano	subst:sg:nom.acc:n
ravioli	ravioli	subst:sg:nom.gen.dat.acc.instr.loc.voc:n+subst:pl:nom.gen.dat.acc.instr.loc.voc:n
raz	raz	subst:sg:nom:m
re	re	ign
reggae	reggae	subst:sg:nom.gen.dat.acc.instr.loc.voc:n+subst:pl:nom.gen.dat.acc.instr.loc.voc:n
rekwiem	rekwiem	subst:sg:nom.gen.dat.acc.instr.loc.voc:n+subst:pl:nom.gen.dat.acc.instr.loc.voc:n
rem	rem	subst:sg:nom:m
requiem	requiem	subst:sg:nom.gen.dat.acc.instr.loc.voc:n+subst:pl:nom.gen.dat.acc.instr.loc.voc:n
retro	retro	subst:sg:nom.gen.dat.acc.instr.loc.voc:n+subst:pl:nom.gen.dat.acc.instr.loc.voc:n
rety	rety	indecl
rozpustniej	rozpustniej	adv
rudoblond	rudoblond	adv
rugby	rugby	subst:sg:nom.gen.dat.acc.instr.loc.voc:n+subst:pl:nom.gen.dat.acc.instr.loc.voc:n
rym	rym	subst:sg:nom:m
rzadziej	rzadziej	adv
równie¿	równie¿	indecl
safari	safari	subst:sg:nom.gen.dat.acc.instr.loc.voc:n+subst:pl:nom.gen.dat.acc.instr.loc.voc:n
sake	sake	subst:sg:nom.gen.dat.acc.instr.loc.voc:f+subst:pl:nom.gen.dat.acc.instr.loc.voc:f
samochc±c	samochc±c	adv
samopas	samopas	adv
samotniej	samotniej	adv
se	se	ign
sekretniej	sekretniej	adv
seppuku	seppuku	subst:sg:nom.gen.dat.acc.instr.loc.voc:n+subst:pl:nom.gen.dat.acc.instr.loc.voc:n
sex	sex	indecl
sexy	sexy	adj:indecl
sexy	sexy	adj:sg:nom:m
sfumato	sfumato	subst:sg:nom.acc:n
sherry	sherry	subst:sg:nom.gen.dat.acc.instr.loc.voc:n+subst:pl:nom.gen.dat.acc.instr.loc.voc:n
show	show	subst:sg:nom.gen.dat.acc.instr.loc.voc:m1+subst:pl:nom.gen.dat.acc.instr.loc.voc:m1
si	si	ign
siak	siak	indecl
siedemkroæ	siedemkroæ	indecl
silniej	silniej	adv
siup	siup	subst:sg:nom:m
siusiu	siusiu	subst:sg:nom.gen.dat.acc.instr.loc.voc:n+subst:pl:nom.gen.dat.acc.instr.loc.voc:n
skandaliczniej	skandaliczniej	adv
skoro	skoro	conj
sko¶niej	sko¶niej	adv
skro¶	skro¶	adv
sk±d	sk±d	indecl
sk±dci¶	sk±dci¶	indecl
sk±din±d	sk±din±d	indecl
sk±dkolwiek	sk±dkolwiek	indecl
sk±d¶	sk±d¶	indecl
sk±d¿e	sk±d¿e	indecl
smyk	smyk	subst:sg:nom:m
snad¼	snad¼	indecl
snobistyczniej	snobistyczniej	adv
sol	sol	subst:sg:nom:m
solo	solo	adv
sp	sp	ign
spaghetti	spaghetti	subst:sg:nom.gen.dat.acc.instr.loc.voc:n+subst:pl:nom.gen.dat.acc.instr.loc.voc:n
spiritus	spiritus	subst:sg:nom.acc:m3
spod	spod	prep:gen
spode	spode	prep:gen
spomiêdzy	spomiêdzy	prep:gen
sponad	sponad	prep:gen
spoza	spoza	prep:gen
spo³em	spo³em	adv
spo¶ród	spo¶ród	prep:gen
sprzed	sprzed	prep:gen
stamt±d	stamt±d	indecl
staromodniej	staromodniej	adv
stereo	stereo	subst:sg:nom.gen.dat.acc.instr.loc.voc:n+subst:pl:nom.gen.dat.acc.instr.loc.voc:n
stokroæ	stokroæ	adv
stop	stop	subst:sg:nom.acc:m3
str	str	ign
stricte	stricte	adv
strzeli¶ciej	strzeli¶ciej	adv
st±d	st±d	indecl
summa	summa	subst:sg:nom:f
super	super	adv
superego	superego	subst:sg:nom.acc.voc:n
szczególniej	szczególniej	adv
szczegó³owiej	szczegó³owiej	adv
szerzej	szerzej	adv
szkoda	szkoda	pred
szt	szt	ign
szumniej	szumniej	adv
szybciej	szybciej	adv
s±	byæ	verb:fin:pl:ter:imperf
tabu	tabu	subst:sg:nom.gen.dat.acc.instr.loc.voc:n+subst:pl:nom.gen.dat.acc.instr.loc.voc:n
tabula	tabula	subst:sg:nom:f
taedium	taedium	subst:sg:nom.acc:n
tak	tak	conj
tako¿	tako¿	indecl
tak¿e	tak¿e	adv
talk	talk	subst:sg:nom:m
tamtêdy	tamtêdy	adv
tam¿e	tam¿e	indecl
tandetniej	tandetniej	adv
tas	tas	subst:sg:nom:m
taxi	taxi	subst:sg:nom.gen.dat.acc.instr.loc.voc:n+subst:pl:nom.gen.dat.acc.instr.loc.voc:n
te	te	ign
tedy	tedy	conj
tel	tel	ign
teraz	teraz	indecl
tertium	tertium	subst:sg:nom.acc:n
te¿	te¿	indecl
tiret	tiret	subst:sg:nom:m
tj	tj	ign
to	to	conj
toffi	toffi	subst:sg:nom.gen.dat.acc.instr.loc.voc:n+subst:pl:nom.gen.dat.acc.instr.loc.voc:n
toples	toples	subst:sg:nom:m
topless	topless	subst:sg:nom:m
tote¿	tote¿	conj
to¿	to¿	indecl
toæ	toæ	indecl
trach	trach	indecl
triennale	triennale	subst:sg:nom.gen.dat.acc.instr.loc.voc:n+subst:pl:nom.gen.dat.acc.instr.loc.voc:n
trochê	trochê	adv
troszeczkê	troszeczkê	adv
troszkê	troszkê	adv
trudniej	trudniej	adv
tru¶	tru¶	subst:sg:nom:m
trzask	trzask	subst:sg:nom.acc:m3
trzeba	trzeba	pred
trzeba¿	trzeba¿	pred
trzykroæ	trzykroæ	adv
trójnasób	trójnasób	adv
tu	tu	indecl
tudzie¿	tudzie¿	indecl
tutaj	tutaj	indecl
tutti	tutti	subst:sg:nom.gen.dat.acc.instr.loc.voc:n+subst:pl:nom.gen.dat.acc.instr.loc.voc:n
tu¿	tu¿	indecl
tv	tv	ign
tyk	tyk	subst:sg:nom:m
tylekroæ	tylekroæ	adv
tylko	tylko	conj
tym	tym	conj
tymczasem	tymczasem	adv
tys	tys	ign
tysi±ckroæ	tysi±ckroæ	indecl
tzn	tzn	ign
tzw	tzw	ign
têdy	têdy	adv
u	u	prep:gen
uczeniej	uczeniej	adv
udry	udry	subst:pl:nom.acc.voc:n
ufo	ufo	ign
ukradkiem	ukradkiem	adv
ultra	ultra	indecl
uni¿eniej	uni¿eniej	adv
upojniej	upojniej	adv
uszczypliwiej	uszczypliwiej	adv
vademecum	vademecum	subst:sg:nom.gen.dat.acc.instr.loc.voc:n
varium	varium	subst:sg:nom.acc:n
vel	vel	indecl
verso	verso	subst:sg:nom.gen.dat.acc.instr.loc.voc:n+subst:pl:nom.gen.dat.acc.instr.loc.voc:n
verte	verte	indecl
via	via	indecl
vice	vice	indecl
video	video	subst:sg:nom.gen.dat.acc.instr.loc.voc:n+subst:pl:nom.gen.dat.acc.instr.loc.voc:n
voto	voto	subst:sg:nom.acc.voc:n
votum	votum	subst:sg:nom.gen.dat.acc.instr.loc.voc:n
w	w	prep:loc
wadliwiej	wadliwiej	adv
wara	wara	indecl
warto	warto	adv
wbrew	wbrew	adv
wcale	wcale	adv
wci±¿	wci±¿	adv
wciórno¶ci	wciórno¶ci	adj:sg:nom:m
wcze¶niej	wcze¶niej	adv
wczoraj	wczoraj	adv
we	we	prep:loc
wedle	wedle	prep:gen
wed³ug	wed³ug	prep:gen
wenus	wenus	subst:sg:nom.gen.dat.acc.instr.loc.voc:f+subst:pl:nom.gen.dat.acc.instr.loc.voc:f
wespó³	wespó³	indecl
wewn±trz	wewn±trz	prep:gen
weñ	weñ	indecl
wg	wg	ign
whisky	whisky	subst:sg:nom.gen.dat.acc.instr.loc.voc:n+subst:pl:nom.gen.dat.acc.instr.loc.voc:n
wiadomo	wiadomo	pred
widaæ	widaæ	pred
widzimisiê	widzimisiê	subst:sg:nom.gen.dat.acc.instr.loc.voc:n+subst:pl:nom.gen.dat.acc.instr.loc.voc:n
wielekroæ	wielekroæ	adv
wio	wio	indecl
wiêc	wiêc	conj
wiêcej	wiêcej	adv
wko³o	wko³o	prep:gen
wkrótce	wkrótce	adv
wnet	wnet	indecl
wniebog³osy	wniebog³osy	adj:sg:nom:m
wniebog³osy	wniebog³osy	adv
wniwecz	wniwecz	indecl
wobec	wobec	prep:gen
woko³o	woko³o	prep:gen
wokó³	wokó³	prep:gen
wolniej	wolniej	adv
wolno	wolno	adv
wolno	wolno	pred
won	won	indecl
wpierw	wpierw	indecl
wprawdzie	wprawdzie	adv
wprost	wprost	adv
wprzód	wprzód	adv
wprzódy	wprzódy	adj:sg:nom:m
wprzódy	wprzódy	qub
wprêdce	wprêdce	adv
wp³aw	wp³aw	adv
wpó³	wpó³	indecl
wraz	wraz	prep
wreszcie	wreszcie	adv
wskro¶	wskro¶	indecl
wskutek	wskutek	prep:gen
wspak	wspak	adv
wstecz	wstecz	indecl
wszak	wszak	indecl
wszak¿e	wszak¿e	adv
wszerz	wszerz	adv
wszystko	wszystko	subst:sg:nom.acc.voc:n
wszêdy	wszêdy	adv
wszêdzie	wszêdzie	adv
wtedy	wtedy	indecl
wtem	wtem	indecl
wtenczas	wtenczas	adv
ww	ww	ign
wyd	wyd	ign
wykrêtniej	wykrêtniej	adv
wynocha	wynocha	indecl
wy¿ej	wy¿ej	adv
wzajem	wzajem	adv
wzd³u¿	wzd³u¿	prep:gen
wznak	wznak	indecl
wzwy¿	wzwy¿	adv
w³a¶nie	w³a¶nie	adv
w³±cznie	w³±cznie	adv
w¶ród	w¶ród	prep:gen
w¿dy	w¿dy	indecl
wówczas	wówczas	adv
yale	yale	subst:sg:nom.gen.dat.acc.instr.loc.voc:n+subst:pl:nom.gen.dat.acc.instr.loc.voc:n
yeti	yeti	subst:sg:nom.gen.dat.acc.instr.loc.voc:n+subst:pl:nom.gen.dat.acc.instr.loc.voc:n
z	z	prep:gen.instr
za	za	prep:acc.gen.instr
zado¶æ	zado¶æ	adv
zaiste	zaiste	adv
zaledwie	zaledwie	adv
zali	zali	indecl
zamiast	zamiast	conj
zamiast	zamiast	prep:gen
zanadto	zanadto	adv
zanim	zanim	conj
zapewne	zapewne	adv
zaprawdê	zaprawdê	adv
zarazem	zarazem	adv
zarówno	zarówno	conj
zatem	zatem	conj
zawczasu	zawczasu	adv
zawdy	zawdy	adv
zawsze	zawsze	adv
zazwyczaj	zazwyczaj	adv
za¶	za¶	conj
zañ	zañ	indecl
ze	ze	prep:gen.instr
zebu	zebu	subst:sg:nom.gen.dat.acc.instr.loc.voc:n+subst:pl:nom.gen.dat.acc.instr.loc.voc:n
zet	zet	subst:sg:nom:m
zewn±trz	zewn±trz	qub
zewsz±d	zewsz±d	indecl
zeñ	zeñ	indecl
zgo³a	zgo³a	adv
znad	znad	prep:instr
znade	znade	prep:instr
znienacka	znienacka	adv
znik±d	znik±d	indecl
znik±din±d	znik±din±d	indecl
znowu	znowu	adv
znowu¿	znowu¿	indecl
znów	znów	adv
zoo	zoo	subst:sg:nom.gen.dat.acc.instr.loc.voc:n+subst:pl:nom.gen.dat.acc.instr.loc.voc:n
zow±d	zow±d	indecl
zreszt±	zreszt±	indecl
zw³aszcza	zw³aszcza	adv
zza	zza	prep:acc.gen.instr
z³	z³	ign
z³oci¶ciej	z³oci¶ciej	adv
³ac	³ac	ign
³acniej	³acniej	adv
³apczywiej	³apczywiej	adv
³aps	³aps	indecl
³atwiej	³atwiej	adv
³up	³up	subst:sg:nom.acc:m3
¶cichapêk	¶cichapêk	subst:sg:nom:m
¶nie¿niej	¶nie¿niej	adv
¶ród	¶ród	prep:gen
¶w	¶w	ign
¶wietli¶ciej	¶wietli¶ciej	adv
¿e	¿e	conj
¿eby	¿eby	conj
¿ywiej	¿ywiej	adv
ówdzie	ówdzie	indecl
